showSettingsMenu : Ctrl-,
goToNextError : Alt-E
goToPreviousError : Alt-Shift-E
selectall : Ctrl-A
gotoline : Ctrl-L
fold : Alt-L|Ctrl-F1
unfold : Alt-Shift-L|Ctrl-Shift-F1
toggleFoldWidget : F2
toggleParentFoldWidget : Alt-F2
foldOther : Alt-0
unfoldall : Alt-Shift-0
findnext : Ctrl-K
findprevious : Ctrl-Shift-K
selectOrFindNext : Alt-K
selectOrFindPrevious : Alt-Shift-K
find : Ctrl-F
overwrite : Insert
selecttostart : Ctrl-Shift-Home
gotostart : Ctrl-Home
selecttoend : Ctrl-Shift-End
gotoend : Ctrl-End
selectdown : Shift-Down
golinedown : Down
selectwordleft : Ctrl-Shift-Left
gotowordleft : Ctrl-Left
selecttolinestart : Alt-Shift-Left
gotolinestart : Alt-Left|Home
selectleft : Shift-Left
gotoleft : Left
selectwordright : Ctrl-Shift-Right
gotowordright : Ctrl-Right
selecttolineend : Alt-Shift-Right
gotolineend : Alt-Right|End
selectright : Shift-Right
gotoright : Right
selectpagedown : Shift-Pagedown
gotopagedown : Pagedown
selectpageup : Shift-Pageup
gotopageup : Pageup
scrollup : Ctrl-Up
scrolldown : Ctrl-Down
selectlinestart : Shift-Home
selectlineend : Shift-End
togglerecording : Ctrl-Alt-E
replaymacro : Ctrl-Shift-E
jumptomatching : Ctrl-\|Ctrl-P
selecttomatching : Ctrl-Shift-\|Ctrl-Shift-P
expandToMatching : Ctrl-Shift-M
removeline : Ctrl-D
duplicateSelection : Ctrl-Shift-D
sortlines : Ctrl-Alt-S
togglecomment : Ctrl-/
toggleBlockComment : Ctrl-Shift-/
modifyNumberUp : Ctrl-Shift-Up
modifyNumberDown : Ctrl-Shift-Down
replace : Ctrl-H
undo : Ctrl-Z
redo : Ctrl-Shift-Z|Ctrl-Y
copylinesup : Alt-Shift-Up
movelinesup : Alt-Up
copylinesdown : Alt-Shift-Down
movelinesdown : Alt-Down
del : Delete
backspace : Shift-Backspace|Backspace
cut_or_delete : Shift-Delete
removetolinestart : Alt-Backspace
removetolineend : Alt-Delete
removetolinestarthard : Ctrl-Shift-Backspace
removetolineendhard : Ctrl-Shift-Delete
removewordleft : Ctrl-Backspace
removewordright : Ctrl-Delete
outdent : Shift-Tab
indent : Tab
blockoutdent : Ctrl-[
blockindent : Ctrl-]
transposeletters : Alt-Shift-X
touppercase : Ctrl-U
tolowercase : Ctrl-Shift-U
expandtoline : Ctrl-Shift-L
openCommandPallete : F1
addCursorAbove : Ctrl-Alt-Up
addCursorBelow : Ctrl-Alt-Down
addCursorAboveSkipCurrent : Ctrl-Alt-Shift-Up
addCursorBelowSkipCurrent : Ctrl-Alt-Shift-Down
selectMoreBefore : Ctrl-Alt-Left
selectMoreAfter : Ctrl-Alt-Right
selectNextBefore : Ctrl-Alt-Shift-Left
selectNextAfter : Ctrl-Alt-Shift-Right
toggleSplitSelectionIntoLines : Ctrl-Alt-L
alignCursors : Ctrl-Alt-A
findAll : Ctrl-Alt-K
showKeyboardShortcuts : Ctrl-Alt-H